####################
####################
####################
####################
####################
####################

#.###############.##
#.................##
#################.##
####....###.##.##.##
#...###.....#..##.##
#.###############.##

####################
####################
####################
####################
####################
####################